XXXXXXXXXXXXXXXXXXXXXXXXXXXXXXXXXXXXXXXXXXXXXXXXXXXXXXXXXXXXXXXXXXXXX...X
Xs..X...............X...............X...........X...................X...X
X...X...XXXXXXXXX...X...XXXXX...XXXXXXXXX...XXXXX...XXXXX...XXXXX...X...X
X...............X.......X...X...........X...........X...X...X.......X...X
XXXXXXXXX...X...XXXXXXXXX...XXXXXXXXX...XXXXX...X...X...X...XXXXXXXXX...X
X.......X...X...............X...........X...X...X...X...X...........X...X
X...X...XXXXXXXXXXXXX...X...X...XXXXXXXXX...XXXXX...X...XXXXXXXXX...X...X
X...X...............X...X...X.......X...........X...........X.......X...X
X...XXXXXXXXXXXXX...XXXXX...XXXXX...X...XXXXX...XXXXXXXXX...X...XXXXX...X
X...........X.......X...X.......X...X.......X...........X...X...........X
X...XXXXX...XXXXX...X...XXXXX...X...XXXXXXXXX...X...X...X...XXXXXXXXXXXXX
X.......X.......X...X...X.......X.......X.......X...X...X.......X.......X
XXXXXXXXXXXXX...X...X...X...XXXXXXXXX...X...XXXXX...X...XXXXX...XXXXX...X
X...........X...X...........X.......X...X.......X...X.......X...........X
X...XXXXX...X...XXXXXXXXX...XXXXX...X...XXXXX...XXXXX...XXXXXXXXXXXXX...X
X...X.......X...........X...........X.......X...X...X...............X...X
X...X...XXXXXXXXX...X...XXXXX...XXXXXXXXX...X...X...XXXXXXXXXXXXX...X...X
X...X...........X...X...X...X...X...........X...............X...X.......X
X...XXXXXXXXX...X...X...X...XXXXX...XXXXXXXXX...XXXXXXXXX...X...XXXXXXXXX
X...X.......X...X...X...........X...........X...X.......X...............X
X...X...XXXXX...XXXXX...XXXXX...XXXXXXXXX...XXXXX...X...XXXXXXXXX...X...X
X...X...................X...........X...............X...............X..eX
X...XXXXXXXXXXXXXXXXXXXXXXXXXXXXXXXXXXXXXXXXXXXXXXXXXXXXXXXXXXXXXXXXXXXXX