X.XXXXXXXXXXXXX
X...X.eX...X.sX
X.X....X.XX...X
X..X.X.X.X..XXX
XX.XXX.X...XXXX
X........X.X.XX
XXXX...X......X
XXXXXXXXXXXXXXX