XXXXXXXXXXXX...eXXX
X...X..X...X......X
X.X....X.XX......XX
X.sX.X.X.X.......XX
XX.XXX.X...X...X..X
X........X.X......X
XXX...X...X......XX
XXXXXXXXXXXX.XXXXXX