.........XXXX....
..XXXXXX.......X.
....XX....X...X..
...XXXXX.........
.XXX...XX..X.X...
.........XXX.....
.s.XXXXX......e..