.........XXXX....
..XXeXXX.......X.
....XX....X...X..
...XX..X....X....
.................
........s........
.................
.XXX...XX..X.X...
.........XXX.....
...XXXXX.........