XXX...XXXXXXX....XXX
Xe...X..X...X......X
X.X.....X.XX......XX
X..X..X.X.X.......X
XX.XX.X.X...X...X..X
X.........X.X......X
XXX...X....X......XX
XXXXXXXX.X....XXX..s