.........XXXX....
..XXeXXX.......X.
....XX....X...X..
...XX..X....X....
.XXX...XX..X.X...
.........XXX.....
.s.XXXXX.........