XXX...XXXXX.XX
X...X..Xe....X
X.X....X...X.X
...X.X.X.....X
X..XXX.....X.X
X........X...X
Xs.X...X.....X
XXX...XXXXXX.X